000000000000000000000
000000000000000000000
000000000000000000000
000000000000000000000
000000000000000000000
000000000000000033000
000000000000000000000
000000000000000000000
111111111111111111111
222222222222222222222