000000000000
000000000000
000000000000
000330000000
000000000000
000000000000
000330000000
000000000000
000000003300
003330000000
000000000000
111111111111
222222222222
000000000000