0000000000000000000000000000000000000000000000000000
0000000000000000000000000000000000000000000000000000
0000000000000000000000000000000000000000000000000000
0003300000000000000000000000000000000000000000000000
0000000000000000000000000000000000000000000000000000
0000000000000000000000000000000000000003300000000000
0003300000000000000000000000000000000000000000000000
0000000000000000000000000000000000003300000000000000
0000000033000000000000000000000000000000000000000000
0033300000000000000000000000000000330000000000000000
0000000000000000000000000000000033000000000000000000
1111111111111111111111111111111111111111111111111111
2222222222222222222222222222222222222222222222222222
0000000000000000000000000000000000000000000000000000