000000000000000000000000000000000000000000000000000000
000000000000000000000000000000000000000000000000000000
000000000000000000000000000000000000000000000000000000
100033000000000000000000000000000000000000000000000001
200000000000000000000000000000000000000000000000000002
200000000000000000000000000000000000000033000000000002
200033000000000000000000000000000000000000000000000002
200000000000000000000000000000000000033000000000000002
200000000330000000000000000000000000000000000000000002
200333000000000000000000000000000003300000000000000002
200000000000000000000000000000000330000000000000000002
211111111111111111111111111111111111111111111111111112
222222222222222222222222222222222222222222222222222222
000000000000000000000000000000000000000000000000000000
